1 2 2 1 3 1 2 2 1 3 1 2 1 1 3 2
1 2 2 1 3 1 2 2 1 3 1 2 1 1 3 2
1 2 2 1 3 1 2 2 1 3 1 2 1 1 3 2
1 2 2 1 3 1 2 2 1 3 1 2 1 1 3 2
1 2 2 1 3 1 2 2 1 3 1 2 1 1 3 2
1 2 2 1 3 1 2 2 1 3 1 2 1 1 3 2
1 2 2 1 3 1 2 2 1 3 1 2 1 1 3 2
1 2 2 1 5 5 5 5 5 3 1 2 1 1 3 2
1 2 2 1 5 4 4 4 4 3 1 2 1 1 3 2
1 2 2 1 5 5 5 5 5 3 1 2 1 1 3 2
1 2 2 1 3 1 2 2 1 3 1 2 1 1 3 2
1 2 2 1 3 1 2 2 1 3 1 2 1 1 3 2
